S   # ###  #  # #  #  #  #  ##   # # ## # ####    #  #   #    #  #####    ## ####  ## ###       # ##
           ##      ##  # #    #        #         ##  # #              ## #       #  #      ##       
  #                                          #  #       ## #  #  #  #           # # # #   #         
 #   # #     #   #  #      # # #    #      #     ## # ##        #               #        # #        
##   #  # # # ## #   ##     ##     ## # #     ##            #        #   #  #  #     #   #   #   ## 
         #            ## #       #        #       #   ##  #  ## #   #  ## #   # #         #         
 #        #      #  #             #  #   #     #     #  ## #  #    #  # # #      #   #       #      
     #            #           #    #                # #       ## #     # #    #   #            # ## 
 #      ##    #     #   ## # ## #     #  # # ###      ##     # #  #   #          #  ##   #   ###    
   # #    #  # ##     #     #   ## ##  #                ##     #          #  # #  #     #   #       
#       ###   #  #   # #             #   #  #       #       #  # #   ###  ##  #    # #   ###      # 
   #  #          #        #                  #   #   #                 #          #  #        #     
      #    #   #  ##          # #  #  #      #     # # #  #      #  #         #   # #   # #  #  #   
 #   #   ##  #   # #         # #  #    # #              #    ##      ##       ##     # # ##   #   ##
 #  #  #  #   # #     # #     #  #        ##   #  #       #      #         ##              #  #  #  
# ## # ##        # # #     #       #     #  #        #    # #  # #     # #       # #  #            #
#        #         #    #        #    #     #    ##   #  #            #     #           ###      #  
            # #           ##   #         #    #         ##         ##      #  # #      #   #   #    
    #    #    #     ##      #  #   #    ##  #         #   ##     #      #    #         #   ##    #  
#  #   #       #  #    #        #    ##      #  #  #                       #                 #      
##  #    #    #    ##         #   #   #     ##  # # #   #  #   #  # #     #  #    #   #  #   #    # 
       # #       #         # # #        #    #    #   #  #     #      # #    #  ##         #     #  
      ##   ##      #     #         #   # #    #       # #    #                   #        #     #  #
#    #   #   #       # #   #   # ##     # #   # #         # #        # #  ## #    #    #   #   #  # 
#     ##    #      #  #   #  #     #  # #    #    #  # #     #   #   #  ##  #       # #   #         
   #      ##  #         #     #      #      #    #  #         ##      #          #      #  #     ## 
     #            # #   ## ###  #        #     ##    #   #  #   #      ##     #     # ##     # ##   
#      #     #                   #  #  # #      # # #    # #       ##    #    #   #      # ##       
#    #   #  #         #      #     ##       #          #      #      ##  #      ##   # ##     ## #  
#     #   #  #   #   #        ##       ##    ##       #  ### ##   #     #   ###             #       
 ###         ### #    #  ##  #  #  #       #     # #  #          #       #          #  #   #     #  
#      #    #       #          # #                 #       # ####     ##  #           #   ##        
#     #  # #   #         #        ##  #      #   # #  #  #      # #  #         #     # ##  #  #  #  
#   #    #   #    #     ## #    #   #     #          # #### ##   #     # # #     #   #  #   ### ##  
 # #  #    ## #     ##    #   #  ##        ##     #  #       #   #           # # ## #             ##
   #     ##    #           # #      ##        ##      #    ##  ##   #   # #         # # #   # ## #  
##    #         #                #       ##      #    #     # # #  #    #    ## #     ##   #        
     # ## #  #   #   #   #            # #   #   #  # ##   #             # #    #  #       #   ###   
     #   ##       #       #  #     #   #       #  #    #    #          # #   #        #     #    #  
##             #    # #       #         #  ## #            #     # #     # #       # #    #    #    
   #       ## #  #  #  # #  # # ##     #       # #  ##     ###   #   ###       #  #       #     # # 
#   #   # #  # #    #   #   #    #     #     # #              # #          #  #  #    #             
 #  # #  # # #   ##   # #         # #              #  #           #   #   #    #     # #    # ###   
  #  #    #   #    #  #      #   #  # #  #    #      #  #      #     #  #  ### # #   #     #        
#   #  #       #    #     # #            # ## #  # #     # # ###   ##           #  #  #    # #      
            #  ##            #            #         ## #  ##      #    #   #   #         #   # ###  
   #  #             #    #   #   #     ###                  # ##   #    #  #   # # #          #     
  #                  #  # #   # # ##        #   #         #  #      #    #          # #  # # #    ##
      #     #        #    ##              #    #    # # ##    #  # # ##      # # #               #  
    #    ##     #  #   #         #   #  #   #  #      #       ##                     #  #  # #     #
  #          #    #   ##  #    # # # #  #      ##            # # # #       #      #       #     #   
  #  #   #      #  #        #          # #       #   # ##           #  #       #    #          ##   
#  # #  ###  # ##     # #     # #  # # #   #  #          ## #  #          ## #   #        #         
          #        #  #     #      #    #    #    #  #  #       ##           #         #    #       
#                   ##       #  #        ##    #  #  # #           # #  #  # #    #        # #  #   
#  # # #   ##   ##   #  #   #     # ## #    #    #    # # #     ##                      #  #   #    
#   # #      # #                      ###          #       ##       #  #     #    #               # 
 ##     #  #      ##      # #   #   #       # #   #  #        #  #  #  #           # #    #         
           #    #  #  #         #         #   # #     #  ###   #   ##  #   #   #      #  #   ##     
#   ## #       #    #     #       #    #       #        #     # #            ## # #  # #   #        
 #      ##          #   #   # #     # #     #    #   #  #  #          #  #         #      #   #     
                ## #    #   # #### #    #  #     #        # ##   #  #  #   # #  # # ##  ##    #   ##
  # #  #  ##  #     # #                      #        #        ####  ##   # #  #      #     #       
 #     #              #           #   ##   # #  # ##  #     # #                 # ###  #  #      ## 
        ## #   ###              # # #    #   # #   # #   # #       #   #      #       #    #        
#           #     #  #  ##  # #       #     #  #         #  #   #    ## #        ##   #   #  #  #   
#     #    #              # ## # #    #    #    ##         #     #     #   #  #         #  #  ##   #
#   #        #   # # #  # #  ##       #          #  ## ##     #    #     ## #        #      #  #    
  # #  #    #              #    #   # #     #    #      # #    #                     #     #       #
##   # #             #   # # # #   ###     ##      #      #   # #  # #  ## #   #     ##  # #  #     
         #    #    ##    # #  # #            #         #      #       #    #   #   #  ###   #    #  
   # ##       #         #          ####  #         #  ###       #      #  #   #  #   #   #     #  ##
 #           # # #   # ##      #      ##   #  #   #       #   ##  #       # #      #  # #   #  #    
#     # #  #  # ## #      #  #   #  #  ##      # #     #    #       # #    # ##     #    #   #   #  
                     #   #   ##              ##      ## ##             ##     # #  #      # #       
#  ##     # #  #    # #   #         #  #  #    #  #       #    ##          #          #  ## # ##    
  #  #   #  #   #      #   #       #   #          #   #  # #    #         ##   #  # #  #    #    #  
#    # #  #   ##      #    ##  #                           # #        #  #        #  #  ## # #  #   
  # # #         #   #    #  ### #     # #  ##  ##      #  #    ###    #    #    #   ###     #     # 
#       #  #   ## #  #     #      #     ##        #   #     #    # ##   ## #  # # #     ##          
#  #  #  #  #        #  #   # #    #       # # #          #    #         #   #  #   #     #    #  # 
#               #   #  # #           #   #    #       #    #    #     # #     #  #    #  #          
#  ##    # #  ##     #     #          #    ##  #   #  #              # #           ##   # #  #      
##          #     #    #  # #     # #                 # # #     #   #           #         #  #     #
        #        #     #                    #      # #      #  ## #   #   #          #           #  
# #   #   # # #        #    #   #     ##   #   #   # # #  #   #  #       #   #  #  #     #  #       
#  ##  #         #  ##    # #               # #   ##  ##  #     #   ##   #    # #  ## # #   #       
 #   #      # #        #          # #      #     #            #  ##      #  #  #       #  # #       
      #  #                       #  # # # #   #     #   #  ##      #    #  # #  #   # ## #   # # # #
## # #     #  #   #         # #                  #    ###               #      #   #          #  #  
     #    #       #   ##             # #  # ###### #         # ###  # #    ###    ### # #     ##  # 
# ##  #  ##      # ##     # ## #       ##           #    #         # #              #      #    #   
            #     #       #  #    #  #             #    #    #        # # #       #    ##         # 
 # #     #      #               #   #   #  ##   #   #   #  #      #     #  #    #   #     #  #  #   
             #     ##  #   #    #  #    #       #           #  #      #         #      #     ##  #  
#    #   #     ###      #          # #    # #   #         #   # #            # #     ###    #  #  # 
#  #      #               ##  ##     ####                 #  #      #  #  ##      #      #      #  #
 #     #        ###   #        #          #   # # #            #           #  #      #  #           
   # #  # #        #  #   #     ###                #            #   #   ##     #       #            
              #     #  #   #               #     # #    #       #   #              # #     # #   # E
